##########################################
# Syntax Coloring Map For LiquidCrystalUI
##########################################

##########################################
# Datatypes (KEYWORD1)
##########################################

LiquidCrystalUI KEYWORD1
ILiquidCrystal	KEYWORD1
LiquidCrystalCharmaps	KEYWORD1
ScrollMode	KEYWORD1
LiquidCrystalView	KEYWORD1
LcdPointerSelectableView	KEYWORD1
LcdScrollableView	KEYWORD1
LcdTextView	KEYWORD1
LcdTitleView	KEYWORD1
LcdCheckableView	KEYWORD1
LcdSwitch	KEYWORD1
LcdCheckBox	KEYWORD1
LcdCharmapOnlyButton	KEYWORD1
LcdTextButton	KEYWORD1
LcdCharTextButton	KEYWORD1
LcdCharmapTextButton	KEYWORD1
LcdCustomView	KEYWORD1
LcdProgressBar	KEYWORD1
LcdGraph	KEYWORD1
LcdPageRow	KEYWORD1
LcdPageLayout	KEYWORD1
LiquidCrystalPage	KEYWORD1
LiquidCrystalPager	KEYWORD1
LiquidCrystal_I2C_Wrapper	KEYWORD1

##########################################
# Methods and Functions (KEYWORD2)
##########################################

getCols	KEYWORD2
getRows	KEYWORD2
clear	KEYWORD2
createChar	KEYWORD2
setCursor	KEYWORD2
write	KEYWORD2
print	KEYWORD2
tick	KEYWORD2
init	KEYWORD2
draw	KEYWORD2
clear	KEYWORD2
stop	KEYWORD2
select	KEYWORD2
unselect	KEYWORD2
beginEditing	KEYWORD2
endEditing	KEYWORD2
getWidth	KEYWORD2
notifyDataChanged	KEYWORD2
getId	KEYWORD2
getXPosition	KEYWORD2
setXPosition	KEYWORD2
getYPosition	KEYWORD2
setYPosition	KEYWORD2
isSelected	KEYWORD2
isEditing	KEYWORD2
hasFocus	KEYWORD2
isSelectable	KEYWORD2
setSelectable	KEYWORD2
isEditable	KEYWORD2
setEditable	KEYWORD2
setText	KEYWORD2
getScrollMode	KEYWORD2
setScrollMode	KEYWORD2
getScrollPeriod	KEYWORD2
setScrollPeriod	KEYWORD2
getText	KEYWORD2
getTextMaxLength	KEYWORD2
getScrollXPosition	KEYWORD2
setValueFun	KEYWORD2
getHasPrevPage	KEYWORD2
setHasPrevPage	KEYWORD2
getHasNextPage	KEYWORD2
setHasNextPage	KEYWORD2
createBackButton	KEYWORD2
createMenuButton	KEYWORD2
createApplyButton	KEYWORD2
setCharmap	KEYWORD2
getCharXPosition	KEYWORD2
getHasChar	KEYWORD2
getHasBorder	KEYWORD2
setHasBorder	KEYWORD2
getCharacter	KEYWORD2
setCharacter	KEYWORD2
setCharmap	KEYWORD2
setOnDraw	KEYWORD2
setOnClear	KEYWORD2
setWidth	KEYWORD2
getHeight	KEYWORD2
setHeight	KEYWORD2
getMinValue	KEYWORD2
setMinValue	KEYWORD2
getMaxValue	KEYWORD2
setMaxValue	KEYWORD2
setValuesFun	KEYWORD2
getSize	KEYWORD2
getItemByIndex	KEYWORD2
getRowsCount	KEYWORD2
getRowByIndex	KEYWORD2
nextItem	KEYWORD2
prevItem	KEYWORD2
resetSelectedItemId	KEYWORD2
getSelectedItemId	KEYWORD2
isDownArrowVisible	KEYWORD2
setDownArrowVisibility	KEYWORD2
navigateTo	KEYWORD2
getCurrentPageId	KEYWORD2

##########################################
# Constants (LITERAL1)
##########################################

_POINTER_CHARMAP_LOCATION	LITERAL1
_ELLIPSIS_CHARMAP_LOCATION	LITERAL1
_BACK_ARROW_CHARMAP_LOCATION	LITERAL1
_MENU_CHARMAP_LOCATION	LITERAL1
_APPLY_CHARMAP_LOCATION	LITERAL1
_LEFT_BORDER_CHARMAP_LOCATION	LITERAL1
_RIGHT_BORDER_CHARMAP_LOCATION	LITERAL1
_OUTLINE_BORDER_CHARMAP_LOCATION	LITERAL1
_PROGRESS_BAR_LEFT_CHARMAP_LOCATION	LITERAL1
_PROGRESS_BAR_MIDDLE_CHARMAP_LOCATION	LITERAL1
_PROGRESS_BAR_RIGHT_CHARMAP_LOCATION	LITERAL1
_GRAPH_1_CHARMAP_LOCATION	LITERAL1
_GRAPH_2_CHARMAP_LOCATION	LITERAL1
_GRAPH_3_CHARMAP_LOCATION	LITERAL1
_GRAPH_4_CHARMAP_LOCATION	LITERAL1
_GRAPH_5_CHARMAP_LOCATION	LITERAL1
_GRAPH_6_CHARMAP_LOCATION	LITERAL1
_GRAPH_7_CHARMAP_LOCATION	LITERAL1
_DOWN_ARROW_CHARMAP_LOCATION	LITERAL1
_BLANK_CHAR	LITERAL1
_FILL_CHAR	LITERAL1
NO_CHAR	LITERAL1
NO_CHARMAP	LITERAL1
_POINTER_CHARMAP	LITERAL1
_SELECTED_POINTER_CHARMAP	LITERAL1
_ELLIPSIS_CHARMAP	LITERAL1
_BACK_ARROW_CHARMAP	LITERAL1
_SELECTED_BACK_ARROW_CHARMAP	LITERAL1
_MENU_CHARMAP	LITERAL1
_SELECTED_MENU_CHARMAP	LITERAL1
_APPLY_CHARMAP	LITERAL1
_SELECTED_APPLY_CHARMAP	LITERAL1
_LEFT_BORDER_CHARMAP	LITERAL1
_RIGHT_BORDER_CHARMAP	LITERAL1
_OUTLINE_BORDER_CHARMAP	LITERAL1
_PROGRESS_BAR_LEFT_CHARMAP	LITERAL1
_PROGRESS_BAR_MIDDLE_CHARMAP	LITERAL1
_PROGRESS_BAR_RIGHT_CHARMAP	LITERAL1
_GRAPH_1_CHARMAP	LITERAL1
_GRAPH_2_CHARMAP	LITERAL1
_GRAPH_3_CHARMAP	LITERAL1
_GRAPH_4_CHARMAP	LITERAL1
_GRAPH_5_CHARMAP	LITERAL1
_GRAPH_6_CHARMAP	LITERAL1
_GRAPH_7_CHARMAP	LITERAL1
_DOWN_ARROW_CHARMAP	LITERAL1
X_CENTER	LITERAL1
NONE_SCROLL_MODE	LITERAL1
AUTO_SCROLL_MODE	LITERAL1
FOCUSED_SCROLL_MODE	LITERAL1

##########################################